"filename", "language", "C", "Java", "HTML", "CSS", "comment", "blank", "total"
"d:\Coding\Learn\C\BuildYourOwnLisp\doge_code.c", "C", 17, 0, 0, 0, 0, 2, 19
"d:\Coding\Learn\C\BuildYourOwnLisp\doge_grammar.c", "C", 19, 0, 0, 0, 0, 2, 21
"d:\Coding\Learn\C\BuildYourOwnLisp\interactive.c", "C", 12, 0, 0, 0, 0, 3, 15
"d:\Coding\Learn\C\BuildYourOwnLisp\parsing.c", "C", 47, 0, 0, 0, 6, 15, 68
"d:\Coding\Learn\C\CourseWork\calFractions.c", "C", 8, 0, 0, 0, 0, 1, 9
"d:\Coding\Learn\C\CourseWork\processDate.c", "C", 8, 0, 0, 0, 0, 1, 9
"d:\Coding\Learn\C\TheCProgrammingLanguage\charpter1\MultiplicationTable.c", "C", 13, 0, 0, 0, 0, 2, 15
"d:\Coding\Learn\C\TheCProgrammingLanguage\charpter1\arr.c", "C", 23, 0, 0, 0, 0, 2, 25
"d:\Coding\Learn\C\TheCProgrammingLanguage\charpter1\const.c", "C", 9, 0, 0, 0, 0, 2, 11
"d:\Coding\Learn\C\TheCProgrammingLanguage\charpter1\countString.c", "C", 8, 0, 0, 0, 0, 1, 9
"d:\Coding\Learn\C\TheCProgrammingLanguage\charpter1\countWords.c", "C", 21, 0, 0, 0, 0, 2, 23
"d:\Coding\Learn\C\TheCProgrammingLanguage\charpter1\hello.c", "C", 5, 0, 0, 0, 0, 1, 6
"d:\Coding\Learn\C\TheCProgrammingLanguage\charpter1\output.c", "C", 7, 0, 0, 0, 6, 0, 13
"d:\Coding\Learn\C\TheCProgrammingLanguage\charpter1\printPrecision.c", "C", 8, 0, 0, 0, 0, 1, 9
"d:\Coding\Learn\C\darkhouse\array.c", "C", 20, 0, 0, 0, 1, 3, 24
"d:\Coding\Learn\C\darkhouse\char.c", "C", 7, 0, 0, 0, 0, 1, 8
"d:\Coding\Learn\C\darkhouse\floatNum.c", "C", 10, 0, 0, 0, 0, 1, 11
"d:\Coding\Learn\C\darkhouse\integer.c", "C", 19, 0, 0, 0, 0, 2, 21
"d:\Coding\Learn\C\darkhouse\randomNum.c", "C", 4, 0, 0, 0, 0, 2, 6
"d:\Coding\Learn\C\darkhouse\typeConvert.c", "C", 7, 0, 0, 0, 0, 1, 8
"d:\Coding\Learn\C\darkhouse\variable.c", "C", 10, 0, 0, 0, 0, 4, 14
"d:\Coding\Learn\C\games\ball.c", "C", 34, 0, 0, 0, 0, 2, 36
"d:\Coding\Learn\C\others\dataTable.c", "C", 20, 0, 0, 0, 0, 3, 23
"d:\Coding\Learn\C\others\maxmin.c", "C", 24, 0, 0, 0, 0, 2, 26
"d:\Coding\Learn\C\others\pointerInArray.c", "C", 31, 0, 0, 0, 1, 1, 33
"d:\Coding\Learn\C\others\replaceStr.c", "C", 0, 0, 0, 0, 0, 1, 1
"d:\Coding\Learn\Java\JavaWeb\HTML\BoxModel\index.html", "HTML", 0, 0, 23, 0, 0, 2, 25
"d:\Coding\Learn\Java\JavaWeb\HTML\SrunLogin\css\style.css", "CSS", 0, 0, 0, 18, 0, 0, 18
"d:\Coding\Learn\Java\JavaWeb\HTML\SrunLogin\index.html", "HTML", 0, 0, 15, 0, 0, 1, 16
"d:\Coding\Learn\Java\JavaWeb\HTML\XLNewsWebsite\index.html", "HTML", 0, 0, 61, 0, 0, 3, 64
"d:\Coding\Learn\Java\JavaWeb\HTML\input.html", "HTML", 0, 0, 38, 0, 0, 1, 39
"d:\Coding\Learn\Java\JavaWeb\HTML\jsLearn.html", "HTML", 0, 0, 33, 0, 0, 4, 37
"d:\Coding\Learn\Java\JavaWeb\HTML\table.html", "HTML", 0, 0, 33, 0, 0, 1, 34
"d:\Coding\Learn\Java\JavaWeb\HTML\vue.js\vue1.html", "HTML", 0, 0, 24, 0, 0, 0, 24
"d:\Coding\Learn\Java\JavaWeb\HTML\window.html", "HTML", 0, 0, 47, 0, 0, 2, 49
"d:\Coding\Learn\Java\java_advanced\NetworkProgram\BS\Server.java", "Java", 0, 40, 0, 0, 6, 3, 49
"d:\Coding\Learn\Web\OnlineBookShop\index.html", "HTML", 0, 0, -15, 0, 0, 0, -15
"Total", "-", 391, 40, 259, 18, 20, 75, 803