"filename", "language", "Java", "Markdown", "comment", "blank", "total"
"d:\Coding\Learn\Java\examples\CountLinesOfCode.java", "Java", 29, 0, 0, 4, 33
"d:\Coding\Learn\Java\examples\DownloadPicFromURL.java", "Java", 38, 0, 3, 6, 47
"d:\Coding\Learn\Java\examples\DownloadPicFromURL_.java", "Java", 36, 0, 0, 4, 40
"d:\Coding\Learn\Java\java_advanced\CharacterDemo.java", "Java", 13, 0, 0, 3, 16
"d:\Coding\Learn\Java\java_advanced\ForEach.java", "Java", 13, 0, 0, 2, 15
"d:\Coding\Learn\Java\java_advanced\SetNesting.java", "Java", 13, 0, 0, 2, 15
"d:\Coding\Learn\Java\java_advanced\StreamDemo.java", "Java", -17, 0, 3, -3, -17
"d:\Coding\Learn\Main.java", "Java", -6, 0, 0, 2, -4
"d:\Coding\Learn\day08-Map集合、Stream流、File类.md", "Markdown", 0, -675, 0, -254, -929
"d:\Coding\Learn\day10-IO流（二）.md", "Markdown", 0, -527, 0, -236, -763
"Total", "-", 119, -1202, 6, -470, -1547